NO ./assets/no_tex.xpm
SO ./assets/so_tex.xpm
WE ./assets/we_tex.xpm
EA ./assets/ea_tex.xpm

C 238,245,255
F 210,227,200

1111111111111111111111111111111111111
1000000010000000100000000010000001001
1000000010000000100000000010000001001
1000000010000000100000000010000001111
1000000010000000100000000010000000011
1000000010000000100000000010000000001
1111111111111111111111111111110111111
1110000000000000000000000000000000001
1111000000000000000000000000000000111
1111110000000000000000000000111111111
1111111111111111000S00011111111111111
1111111111111111111111111111111111111
