   NO   ./assets/no_tex.xpm          



C                  12                   ,                     89     ,                               165      


                SO                               ./assets/so_tex.xpm                                       
WE ./assets/we_tex.xpm
EA ./assets/ea_tex.xpm

C                  12                   ,                     89     ,                               165      
F                   58    ,                       90    ,                     64                                       


        11111111111111111111111
        10S000000000000111001111
        1000000011100000010000001
        111111000010000000001000111111111111111                                 
111111111110000001110011000010011111      11111111                                 
100000001000000001111111111111111111       11111111111       
110000000000000111000000100011111111      111111111111                       
110000100001110111000000100011111111      11111111111111                      
111101111111110111010100100011111111      11111111111111
110000001101011111000000100011111111      1111111111111
1000000000000000110000001000111111111111111111111
111110000000000000000001111111111111
    11000000000011110011000000000001
     111000000011   110001100010000001
   111111101111111111111100010001111
   100000111 1000001 100000000001
   10000001  1000001 100000000001
   11111111  1111111 11111111111111
