

NO ./assets/42no_tex.xpm


SO ./assets/424so_tex.xpm
WE ./assets/42we_tex.xpm







EA ./assets/42ea_tex.xpm


F 79,79,79

C 232,240,222

11111
10001
10001
10001
10001
10001
10001
10001
10001
10001
1E001
10001
10001
10001
11111

   
