
NO ./assets/no_tex.xpm
SO ./assets/so_tex.xpm

EA ./assets/ea_tex.xpm


WE ./assets/we_tex.xpm

F 199, 189, 161
C 189, 211, 222




        1111111111111111111111111
        1011000000110000000000001
        1011000101110000000000001
        1000010001110000000000001
11111111100100N001110000000000001
1000000000010011111111111111110111111111111
1011111111111111000000001010000000000000001
1011011111111101110111111100000000000000001
1010000001010101110000000010000000000000011       
1010111100000000000000001000000000000001111
1010100100000000110101001000111111111111111  
1010100111010101110101101000111  
10001111 1110101 101111010001    
11111111 1111111 111111111111    







