NO ./assets/no_tex.xpm


SO ./assets/so_tex.xpm

WE ./assets/we_tex.xpm


EA ./assets/ea_tex.xpm


F 220,100,255
C 225,30,0


        1111111111111111111111111
        1000000000110000000000001
        1011000001110000000000001
        1001000000000000000000001
111111111011000001110000000000001
100000000011000001110111111111111
11110111111111011100000000001
11110111111111011101010010001                   111
110000001101010111000W0010001                   101
10000000000000001100000000001                   111
10000000000000001101010010001
1100000111010101111101111000111
11110111 1110101 101111010001
11111111 1111111 111111111111
