NO ./assets/no_tex.xpm

SO ./assets/so_tex.xpm

WE ./assets/we_tex.xpm

EA ./assets/ea_tex.xpm

F 50,10,50
C 0,0,100

111111111111111111111111111111111111111111111111111
1S1000000000100000100010000000000000000000000000001
101011101110101110101110111111111111111110111111101
101010100010001010100010100000000000000000100000101
101010111011111010111010101111111111111111101011101
101000100010000010001000101010000000000010001010001
101111101110101111101111101010111011111011101110111
101000100010100000101000001000101010001000001000101
101010111010111011101011111011101010101111101011101
101010001010001000001010001000001010100000001010001
101011101011101111111011101111101011111111111010111
101000100010101000000000100000101000100010001010001
101110111110101110111110101111101110101010101010101
100010001000100010100000100000100010101000101010101
111011101010111011101111111110111010101111101010101
101010001010001000101010000000100010001000001010101
101010111111101110101010101111101111111011111010101
101000100000001000101010100000000010001010000010101
101111101111101011101010111110111110101010111111101
100000001000101000001000100010100000101010100000001
101111111010111111111011101011101111101010101111101
100010001010000000101000101000001000100010101010001
101010101011101110101110101011111010111010101010111
101000101010101000000010101010001010000010101010101
101111101010101111111110101110101011111110101010101
101000100010100000000000100010101010000000101000001
101110111110111111111111111010101110111111101111101
100010100010001000000000101000100000100000000010101
111010101010101010111110101111111111101111111010101
100010001000100010100010001000000000101000000010101
101110111111111110111011101011111011101011111110101
100010100010000000100000101010100010001000100000001
111011101010111111101111101010101110111110111110111
101000001000100000001000101000100000100010100010001
101111111111101111111010101110111111101010101011111
100000100000001000000010101000000000001010001000001
101011101011111011111110101111111111111011111111101
101010001000100010001000100000000010001000001010001
101010111110101111101011111111111010101111101010111
101000100000100000001010000000100010100010000010001
101111101111111110111010111110101110101110111111101
100010001000001000100010100010001000101000100000001
111110111011101011101110111011111011101011101111101
100000100010100010100010000010100000100010001000101
101111101110111110111011111010101111111110111010101
100000101000000000001000100010001000100010100010001
101110101111111110111011101111111010101010101111111
100010101000100010001010001000000010101010101000001
111010101010101011101010111011111110101010101111101
100010000010001000001000000010000000001000100000001
111111111111111111111111111111111111111111111111111
