NO ./assets/no_tex.xpm
SO ./assets/so_tex.xpm
WE ./assets/we_tex.xpm
EA ./assets/ea_tex.xpm

              C 238,245,255
F 210,227,200

111111111111111111111111111111111111111111111111111111111111111111111
1E000000000000000000000000000000000000000000000000000000000000000001
10000000000010101010101010101010101101010101010101010101100000000111
111111111111111111111111111111111111111111111111111111111111111110011111111111111111111111
1111111111111111111111111111111111111111111111111111111111111111111111111111111111111111
