NO ./path_to_no

SO ./path_to_so

WE ./path_to_we

EA ./path_to_ea

F 200,200,200
C 200,200,200

111111111111111111
100000000S00000001
111111111111111111
111
101111111111111111
111