C 238,245,255
F 210,227,200



NO ./assets/textures/wood_wall_1.png
SO ./assets/textures/wood_wall_2.png
WE ./assets/textures/wood_wall_3.png
EA ./assets/textures/wood_wall_4.png


11111111111111111111
10000000100000101001
10010000000100001001
10001000100010001001
10000000100001001011
10000000100000001001
11111100111111111111
11111000000000011111
11110010000100001111
11110000000001001111
111100N0100000001111
11111111111111111111
