  111111
  100001
1110011
100N001
100001
111111
