NO ./path_to_no.xpm

SO ./path_to_so.xpm

WE ./path_to_we.xpm

EA ./path_to_ea.xpm

F -200,200,200
C 200,200,200

111111111111111111
10000000000S000001
111111111111111111
