NO cub3d-tester/textures/wall.xpm
SO cub3d-tester/textures/bricks.xpm
WE cub3d-tester/textures/gold.xpm
EA cub3d-tester/textures/wood.xpm
F 220,111,119
C 225,111,200

111111
1CCPC1
1CC0C1
111011
1CC001
111111
1000E1
111111