
WE cub3d-tester/textures/gold.xpm
NO cub3d-tester/textures/wall.xpm


EA cub3d-tester/textures/wood.xpm

F 220,111,119
SO cub3d-tester/textures/bricks.xpm
C 225,111,0

 111111      11111111111
  111001     10000000001
11 1001     10000010001
101N01     1000001 1001
10110111111100001  101
110000000000001001 101
 11111111111111111 111