111111
100001
111001
100N01
1000a1
111111
