 101111
100001
111001
100N01
100001
110111
