









WE cub3d-tester/textures/gold.xpm











EA cub3d-tester/textures/wood.xpm

SO cub3d-tester/textures/bricks.xpm










NO cub3d-tester/textures/wall.xpm




F 220,111,119
C 225,111,200


 111111
100001
111001
100N00
100001
111111
