C 225,111,200










WE cub3d-tester/textures/gold.xpm











EA cub3d-tester/textures/wood.xpm

SO cub3d-tester/textures/bricks.xpm





F 220,111,119





NO cub3d-tester/textures/wall.xpm














 111111
  111001
10 1001
101N01
101101
111 11
